▓▓▓▓▓▓▓▓▓▓▓▓▓▓▓▓▓▓▓▓▓▓▓▓▓▓▓▓▓▓▓▓▓▓▓▓▓▓▓▓▓▓▓
▓.........................................▓
▓.▓▓▓.▓▓▓.▓▓▓.▓▓▓.▓▓▓.▓▓▓.▓▓▓.▓▓▓.▓▓▓.▓▓▓.▓
▓.▓▓▓.▓▓▓.....▓▓▓.▓▓▓.▓▓▓.....▓▓▓.....▓▓▓.▓
▓.....▓▓▓.▓▓▓.▓▓▓.▓▓▓.....▓▓▓.▓▓▓.▓▓▓.....▓
▓.▓▓▓.▓▓▓.▓▓▓.....▓▓▓.▓▓▓.▓▓▓.....▓▓▓.▓▓▓.▓
▓.▓▓▓.........▓▓▓.....▓▓▓.....▓▓▓.....▓▓▓.▓
▓.▓▓▓.▓▓▓.▓▓▓.▓▓▓.▓▓▓.....▓▓▓.....▓▓▓.▓▓▓.▓
▓.............▓▓▓.▓▓▓.▓▓▓.▓▓▓.▓▓▓.▓▓▓.....▓
▓.▓▓▓.▓▓▓.▓▓▓.........▓▓▓.....▓▓▓.▓▓▓.▓▓▓.▓
▓.▓▓▓.....▓▓▓.▓▓▓.▓▓▓.....▓▓▓.........▓▓▓.▓
▓.▓▓▓.▓▓▓.............▓▓▓.▓▓▓.▓▓▓.▓▓▓.▓▓▓.▓
▓.........▓▓▓.▓▓▓.▓▓▓.▓▓▓.▓▓▓.▓▓▓.▓▓▓.....▓
▓.▓▓▓.▓▓▓.▓▓▓.▓▓▓.▓▓▓.................▓▓▓.▓
▓.▓▓▓.▓▓▓.........▓▓▓.▓▓▓.▓▓▓.▓▓▓.▓▓▓.▓▓▓.▓
▓.▓▓▓.▓▓▓.▓▓▓.▓▓▓.▓▓▓.▓▓▓.▓▓▓.▓▓▓.▓▓▓.▓▓▓.▓
▓.........................................▓
▓▓▓▓▓▓▓▓▓▓▓▓▓▓▓▓▓▓▓▓▓▓▓▓▓▓▓▓▓▓▓▓▓▓▓▓▓▓▓▓▓▓▓
