▓▓▓▓▓▓▓▓▓▓▓▓▓▓▓▓▓▓▓▓▓▓▓▓▓▓▓▓▓▓▓▓▓▓▓▓▓▓▓
▓.....................................▓
▓.▓▓▓.▓▓▓.▓▓▓.▓▓▓.▓▓▓.▓▓▓.▓▓▓.▓▓▓.▓▓▓.▓
▓.▓▓▓.▓▓▓.....▓▓▓.▓▓▓.▓▓▓.....▓▓▓.....▓
▓.....▓▓▓.▓▓▓.▓▓▓.▓▓▓.....▓▓▓.▓▓▓.▓▓▓.▓
▓.▓▓▓.▓▓▓.▓▓▓.....▓▓▓.▓▓▓.▓▓▓.....▓▓▓.▓
▓.▓▓▓.........▓▓▓.....▓▓▓.....▓▓▓.....▓
▓.▓▓▓.▓▓▓.▓▓▓.▓▓▓.▓▓▓.....▓▓▓.....▓▓▓.▓
▓.............▓▓▓.▓▓▓.▓▓▓.▓▓▓.▓▓▓.▓▓▓.▓
▓.▓▓▓.▓▓▓.▓▓▓.........▓▓▓.....▓▓▓.▓▓▓.▓
▓.▓▓▓.....▓▓▓.▓▓▓.▓▓▓.....▓▓▓.........▓
▓.▓▓▓.▓▓▓.............▓▓▓.▓▓▓.▓▓▓.▓▓▓.▓
▓.........▓▓▓.▓▓▓.▓▓▓.▓▓▓.▓▓▓.▓▓▓.▓▓▓.▓
▓.▓▓▓.▓▓▓.▓▓▓.▓▓▓.▓▓▓.................▓
▓.▓▓▓.▓▓▓.........▓▓▓.▓▓▓.▓▓▓.▓▓▓.▓▓▓.▓
▓.▓▓▓.▓▓▓.▓▓▓.▓▓▓.▓▓▓.▓▓▓.▓▓▓.▓▓▓.▓▓▓.▓
▓.....................................▓
▓▓▓▓▓▓▓▓▓▓▓▓▓▓▓▓▓▓▓▓▓▓▓▓▓▓▓▓▓▓▓▓▓▓▓▓▓▓▓
