▓▓▓▓▓▓▓▓▓▓▓▓▓▓▓▓▓▓▓▓▓▓▓▓▓▓▓▓▓
▓...........................▓
▓.▓.▓.▓.▓.▓.▓.▓.▓.▓.▓.▓.▓.▓.▓
▓.▓.▓.▓.▓.▓.▓.▓.▓.▓.▓.▓.▓.▓.▓
▓.▓.▓.▓.▓.▓.▓.▓.▓.▓.▓.▓.▓.▓.▓
▓...........................▓
▓.▓.▓.▓.▓.▓.▓.▓.▓.▓.▓.▓.▓.▓.▓
▓.▓.▓.▓.▓.▓.▓.▓.▓.▓.▓.▓.▓.▓.▓
▓...........................▓
▓.▓.▓.▓.▓.▓.▓.▓.▓.▓.▓.▓.▓.▓.▓
▓.▓.▓.▓.▓.▓.▓.▓.▓.▓.▓.▓.▓.▓.▓
▓...........................▓
▓.▓.▓.▓.▓.▓.▓.▓.▓.▓.▓.▓.▓.▓.▓
▓.▓.▓.▓.▓.▓.▓.▓.▓.▓.▓.▓.▓.▓.▓
▓.▓.▓.▓.▓.▓.▓.▓.▓.▓.▓.▓.▓.▓.▓
▓...........................▓
▓▓▓▓▓▓▓▓▓▓▓▓▓▓▓▓▓▓▓▓▓▓▓▓▓▓▓▓▓
