▓▓▓▓▓▓▓▓▓▓▓▓▓▓▓▓▓▓▓▓▓▓▓▓▓▓▓▓▓▓▓▓▓
▓...............................▓
▓.▓▓▓▓▓▓▓.▓▓▓.▓▓▓.▓.▓▓▓.▓▓▓▓▓▓▓.▓
▓...▓...▓.▓.....▓.▓...▓.▓.......▓
▓.▓.▓.▓.▓.▓.▓▓▓.▓.▓.▓.▓...▓▓.▓▓.▓
▓.▓...▓...▓.▓▓▓.▓...▓.▓▓▓.......▓
▓.▓▓▓▓▓▓..........▓.....▓.▓▓.▓▓.▓
▓........▓▓▓▓.▓▓▓.▓.▓▓▓.▓.▓▓.▓▓.▓
▓.▓▓▓.▓▓.▓.▓....................▓
▓...▓.▓..▓.▓.▓.▓▓▓▓▓.▓▓▓▓▓▓▓.▓▓.▓
▓.▓.▓.▓▓.....................▓▓.▓
▓.▓.▓....▓▓.▓▓▓▓▓.▓▓▓▓.▓▓.▓▓.▓▓.▓
▓.....▓▓.▓▓.....................▓
▓........▓▓▓▓.▓▓▓.▓.▓▓▓.▓.▓▓▓▓▓.▓
▓.▓▓▓.▓▓.▓.▓....................▓
▓...▓.▓..▓.▓.▓.▓▓▓▓▓.▓▓▓▓.▓▓▓▓▓.▓
▓.....▓▓........................▓
▓▓▓▓▓▓▓▓▓▓▓▓▓▓▓▓▓▓▓▓▓▓▓▓▓▓▓▓▓▓▓▓▓
